日期,累计确诊,现有确诊（含重症）,现有疑似,现有重症,累计死亡,累计治愈,累计确诊+现有疑似,新增确诊,新增疑似,新增(疑似+确诊),死亡/确诊,观察中,更新时间,备注
20/1/2020,291,-,54,-,6,25,345,77,27,104,2.06%,922,21/1/2020,截至1月20日24时
21/1/2020,440,-,37,102,9,28,477,149,26,175,2.05%,1394,22/1/2020,截至1月21日24时
22/1/2020,571,-,393,95,17,49,964,131,257,388,2.98%,4928,23/1/2020,截至1月22日24时
23/1/2020,830,-,1072,177,25,34,1902,259,680,939,3.01%,8420,24/1/2020,截至1月23日24时
24/1/2020,1287,-,1965,237,41,38,3252,444,1118,1562,3.19%,13967,25/1/2020,截至1月24日24时
25/1/2020,1975,-,2684,324,56,49,4659,688,1309,1997,2.84%,21556,26/1/2020,截至1月25日24时
26/1/2020,2744,-,5794,461,80,51,8538,769,3806,4575,2.92%,30453,27/1/2020,截至1月26日24时
27/1/2020,4515,-,6973,976,106,60,11488,1771,2077,3848,2.35%,44132,28/1/2020,截至1月27日24时
28/1/2020,5974,-,9239,1239,132,103,15213,1459,3248,4707,2.21%,59990,29/1/2020,截至1月28日24时
29/1/2020,7711,-,12167,1370,170,124,19878,1737,4148,5885,2.20%,81947,30/1/2020,截至1月29日24时
30/1/2020,9692,-,15238,1527,213,171,24930,1982,4812,6794,2.20%,102427,31/1/2020,截至1月30日24时
31/1/2020,11791,-,17988,1795,259,243,29779,2102,5019,7121,2.20%,118478,1/2/2020,截至1月31日24时
1/2/2020,14380,-,19544,2110,304,328,33924,2590,4562,7152,2.11%,137594,2/2/2020,截至2月1日24时
2/2/2020,17205,-,21558,2296,361,475,38763,2829,5173,8002,2.10%,152700,3/2/2020,截至2月2日24时
3/2/2020,20438,-,23214,2788,425,632,43652,3235,5072,8307,2.08%,171329,4/2/2020,截至2月3日24时
4/2/2020,24324,-,23260,3219,490,892,47584,3887,3971,7858,2.01%,185555,5/2/2020,截至2月4日24时
5/2/2020,28018,-,24702,3859,563,1153,52720,3694,5328,9022,2.01%,186354,6/2/2020,截至2月5日24时
6/2/2020,31161,28985,26359,4821,636,1540,57520,3143,4833,7976,2.04%,186045,7/2/2020,截至2月6日24时
7/2/2020,34546,31774,27657,6101,722,2050,62203,3399,4214,7613,2.09%,189660,8/2/2020,截至2月7日24时
8/2/2020,37198,33738,28942,6188,811,2649,66140,2656,3916,6572,2.18%,188183,9/2/2020,截至2月8日24时
9/2/2020,40171,35982,23589,6484,908,3281,63760,3062,4008,7070,2.26%,187518,10/2/2020,截至2月9日24时
10/2/2020,42638,37626,21675,7333,1016,3996,64313,2478,3536,6014,2.38%,187728,11/2/2020,截至2月10日24时
11/2/2020,44653,38800,16067,8204,1113,4740,60720,2015,3342,5357,2.49%,185037,12/2/2020,截至2月11日24时
12/2/2020,59804,52526,13435,8030,1367,5911,73239,15152,2807,17959,2.29%,181386,13/2/2020,截至2月12日24时
13/2/2020,63851,55748,10109,10204,1380,6723,73960,5090,2450,7540,2.16%,177984,14/2/2020,截至2月13日24时
14/2/2020,66492,56873,8969,11053,1523,8096,75461,2641,2277,4918,2.29%,169039,15/2/2020,截至2月14日24时
15/2/2020,68500,57416,8228,11272,1665,9419,76728,2009,1918,3927,2.43%,158764,16/2/2020,截至2月15日24时
16/2/2020,70548,57934,7264,10644,1770,10844,77812,2048,1563,3611,2.51%,150539,17/2/2020,截至2月16日24时
17/2/2020,72436,58016,6242,11741,1868,12552,78678,1886,1432,3318,2.58%,141552,18/2/2020,截至2月17日24时
18/2/2020,74185,57805,5248,11977,2004,14376,79433,1749,1185,2934,2.70%,135881,19/2/2020,截至2月18日24时
19/2/2020,74576,56303,4922,11864,2118,16155,79498,394,1277,1671,2.84%,126363,20/2/2020,截至2月19日24时
20/2/2020,75465,54965,5206,11633,2236,18264,80671,889,1614,2503,2.96%,120302,21/2/2020,截至2月20日24时
21/2/2020,76288,53284,5365,11477,2345,20659,81653,397,1361,1758,3.07%,113564,22/2/2020,截至2月21日24时
22/2/2020,76936,51606,4148,10968,2442,22888,81084,648,882,1530,3.17%,106089,23/2/2020,截至2月22日24时
23/2/2020,77150,49824,3434,9915,2592,24734,80584,409,620,1029,3.36%,97481,24/2/2020,截至2月23日24时
24/2/2020,77658,47672,2824,9126,2663,27323,80482,508,530,1038,3.43%,87902,25/2/2020,截至2月24日24时
25/2/2020,78064,45604,2491,8752,2715,29745,80555,406,439,845,3.48%,79108,26/2/2020,截至2月25日24时
26/2/2020,78497,43258,2358,8346,2744,32495,80855,433,508,941,3.50%,71572,27/2/2020,截至2月26日24时
27/2/2020,78824,39919,2308,7952,2788,36117,81132,327,452,779,3.54%,65225,28/2/2020,截至2月27日24时
28/2/2020,79251,37414,1418,7664,2835,39002,80669,427,248,675,3.58%,58233,29/2/2020,截至2月28日24时
29/2/2020,79824,35329,851,7365,2870,41625,80675,573,132,705,3.60%,51856,1/3/2020,截至2月29日24时
1/3/2020,80026,32652,715,7110,2912,44462,80741,202,141,343,3.64%,46219,2/3/2020,截至3月1日24时
2/3/2020,80151,30004,587,6806,2943,47204,80738,125,129,254,3.67%,40651,3/3/2020,截至3月2日24时
3/3/2020,80270,27433,520,6416,2981,49856,80790,119,143,262,3.71%,36432,4/3/2020,截至3月3日24时
4/3/2020,80409,25352,522,5952,3012,52045,80931,139,143,282,3.75%,32870,5/3/2020,截至3月4日24时
5/3/2020,80552,23784,482,5737,3042,53726,81034,143,102,245,3.78%,29896,6/3/2020,截至3月5日24时
6/3/2020,80651,22177,502,5489,3070,55404,81153,99,99,198,3.81%,26730,7/3/2020,截至3月6日24时
7/3/2020,80695,20533,458,5264,3097,57065,81153,44,84,128,3.84%,23074,8/3/2020,截至3月7日24时